....................
....................
....................
..X..........G.AZ...
#####...R...#####..L
...................L
...................L
.........BG........L
.GGF.....###..--...L
#####..............L
.............Q.GG..L
............######.L
....................
.1...#.G.A.K##...G..
####################
